...#......#......#......#...
...#......#......#......#...
.#####..#####..#####..#####.
...#......#......#......#...
...#......#......#......#...
............................
............................
............................
............................
