.........#........#.........
.......#####....#####.......
.........#........#.........
............................
..#......................#..
...#....................#...
....#..................#....
.....#................#.....
......################......
